16
0000000000000000000000000000000000000000
0666666666666666666666666666666666666660
0666666666666666666666666666666666666660
0666666666666666666666666666666666666660
0666666666666666666666666666666666666660
0666666666666666666666666666666666666660
0666666666666666666666666666666666666660
0666666666666666666666666666666666666660
0666666666666666666666666666666666666660
0666666666666666666666666666666666666660
0666666666666666666666666666666666666660
0666666666666666666666666666666666666660
0666666666666666666666666666666666666660
0666666666666610666026666666666666666660
0666666666666100666002666666666666666660
0666666666661000666000266666666666666660
0666666666666666666666666666666666666660
0666666666666666666666666666666666666660
0666100026666666666666666666666666666660
0661000002666666666666666666666666666660
0610000000266666666666666666666666666660
0100000000026666666666666663334445550000
0000000000000000000000000000000000000000
0000000000000000000000000000000000000000
0000000000000000000000000000000000000000
0000000000000000000000000000000000000000
0000000000000000000000000000000000000000
0000000000000000000000000000000000000000
0000000000000000000000000000000000000000
0000000000000000000000000000000000000000
